00022222222200000000000000000000000002222222222220
00021112211222222222222222222200022222111111331120
00021112211221113311111122111200021122111111221120
00022322211221112211111122111200021122222211221120
22222322223222222222221122322200021120000211222220
21122112223222222222221122322222221120000211200000
21133112211133111111221122112211111120000211200000
21122112211122111111221122113311111122222223222222
22322222222222222211222322112222222222112223221112
02322000022220000211222322112222200002112211221112
02112000021120000211221122111111200002112211331112
02112000021120000211221133111111200002232211221112
02112000021120000223221122222222200002232211222222
02112222221122222223221120000222222222111111200000
02111111221111112211111120000211111133111111200000
02111111331111113311111120000211111122222222200000
02222222222222222222222320000211222220000022222000
00000000000002222222222322222211202222222221112000
00000000000002111111331111113311202111111331112000
00000000000002111111221111112211202111111222222000
02222222222222112222222222112222202112222200000000
02111111221122112000222222112222222112000222222220
02111111221133112000211133112211133112000211111120
02222211221122112000211122112211122112000211111120
00000211222222222000222222232222222322000211223220
00000211222222222222222222232222222322222211223220
00000211221111113311111133111111331111113311221120
02222223221111112211111122111111221111112211221120
02112223221122222222221122222211222222112222221120
02112211221122222222221120000211200002112000022220
02112211331122111111331120000211200002112000000000
02232211221122111111221120000211200002112000022222
02232211223222112222222322222223200002232000021112
02111111223222112000022322112223222222232222221112
02111111221122112000021122112211221122111111331112
02222223221122112000021122112211331122111111221112
00000223221122322000021122232211221122222211222222
00000211222222322222221122232211222220000211200000
00000211200002112211111122111111200000000211200000
00000211200002112211111122111111200000000211200000
02222211200002112222222322222223200000000223222222
02111111200002222000022320000223222222000223221112
02111111200022222000021120000211221112000211221112
02222223200021112000021120000211331112000211331112
00000223222021112000021120000211222222000211221112
00000211112022322222221122222211222222222211222222
00000211112022322211111122111111221122111111200000
00000211112021113311111122111111221133111111200000
00000222222021112222222222222222221122222222200000
00000000000022222000000000000000022220000000000000
